11111111
1RRRRRP1
1CERRRR1
11111111