11111111
100C00E1
10000001
1P0000C1
11111111